111111111
1000PCE11
110000001
1CC000001
111111111