1111111111
1000000001
10C00100C1
1P001100E1
1111111111