1111111111111
100000PC000E1
1100C10011001
1111111111111